NO ./textures/north.xpm
SO ./textures/south.xpm
WE ./textures/west.xpm
EA ./textures/east.xpm

F 107,142,86
C 135,195,235

        1111111111111111111111
        1000000000000000000001
        1000000000000000000001
        1000000000000000000001
        1000001000000000100001
        1000001000000000100001
        1000001000000000100001
        1000000000000000000001
        1000000000000000000001
        100000000S000000000001
        1000000000000000000001
        1000000000000000000001
        1000001000000000100001
        1000001000000000100001
        1000001000000000100001
        1000000000000000000001
        1000000000000000000001
        1000000000000000000001
        1111111111111111111111
